O.##......
#.##..###.
#.###.###.
#.....###.
###.#####H
