..##......
#.##..###.
#.###.###.
#..H..###.
###.#####.
